 # ####   ######         ###########    ########################################
           ## #####         #######      #######################################
#       #####    #####                     #####################################
###        ###    #########                 ####################################
#####               ###############          ###################################
#####              ####   #######         ######################################
#####       ##########    ###           ########################################
#####        ########     #####      ###########################################
#######         ###         #####      #########################################
##########                               #######################################
############                          ##########################################
################################################################################
################################################################################
